        F         111,222,121   


        EA        ./textures/greystone.xpm               

NO ./textures/wood.xpm


C 222,111,212




                SO       ./textures/redbrick.xpm    










WE       ./textures/mossy.xpm
        1111111111111111111111111
        1000000000110000000000001
        1111000001110000000000001
        1101000000000000000000001
111111111011000001000000000000001
100000000011000001110111111111111
111101111111110111000000100011111
11110111111111011101010010001
11000000110101011100000010001
1000S000000000001100000010001
10000000000000001101010010001
1100000111010101111101111000111
11110111 1110101 101111010001
11111111 1111111 111111111111