

NO ./textures/wood.xpm
                SO       ./textures/redbrick.xpm    



WE       ./textures/mossy.xpm
        EA        ./textures/greystone.xpm               

        F         111 , 222     , 120   








C 222   , 111, 212





          1111111111111111111111111
          1000000000110000000000001
          1111000001110000000000001
          110100000000000000000N001
  111111111011000001110000000000001
  100000000000001111111101110111111
  111101111111111     100010001
  111101111111111     110010001
  11000000110101111111100000001
  10000000000000001100000010001
  10000000000000000001010010001
  1100000111010101111101111000111
  11110111 1110101 101111010001
  111111111 11111111111111111111