

NO ./textures/wood.xpm
                SO       ./textures/redbrick.xpm    



WE       ./textures/mossy.xpm
        EA        ./textures/greystone.xpm               

        F         111,222,120   


                                
C 222,111,212
                        

1111111
1100111
1N00001
1111111