        F         111,222,121   


        EA        ./textures/greystone.xpm               

NO ./textures/wood.xpm


C 222,111,212




                SO       ./textures/redbrick.xpm    










WE       ./textures/mossy.xpm
11111111111111111111111111111111111
11101010101000101010100010101010111
10000000000100000000000100000000001
11100000000000000000000000000000111
10000000000001000000010000000000001
11111111100000111111100000111111111
10000000000000100000100000000000001
11110000100000100000100000100001111
10000000100000100E00000000100000001
11110000100000100000100000100001111
10000000000000100000100000000000001
11111111100000111111100000111111111
10000000000001000000010000000000001
11100000000000000000000000000000111
10000000000100000000000100000000001
11101010101000101010100010101010111
11111111111111111111111111111111111