

NO ./path_to_the_north_texture.xpm
                SO       ./path_to_the_south_texture.xpm    



WE       ./path_to_the_west_texture.xpm
        EA        ./path_to_the_east_texture.xpm               

        F         111,222,120   








C 222,111,212





          1111111111111111111111111
          1000000000110000000000001
          1111000001110000000000001
          11010000000000000000EN001
  111111111011000001110000000000001
  100000000011000001110111111111111
  11110111111111011100000010001
  11110111111111011101010010001
  11000000110101011100000010001
  10000000000W00001100000010001
  10000000000000001101010010001
  1100000111010101111101111000111
  11110111 1110101 101111010001
  11111111 1111111 11111111111111
